Mil Tech;Name;Fire Off;Fire Def;Shock Off;Shock Def;Morale Off;Morale Def;Total Pips
7;Houfnice;1;0;0;0;0;1;2
7;Large Cast Bronze Mortar;0;0;0;0;2;0;2
10;Culverin;2;1;0;1;0;0;4
10;Pedrero;1;0;0;2;1;0;4
13;Large Cast Iron Cannon;2;1;0;1;2;0;6
13;Small Cast Iron Cannon;1;1;0;1;2;1;6
16;Chambered Demi Cannon;2;2;0;1;2;1;8
18;Leather Cannon;3;2;1;1;2;1;10
20;Swivel Cannon;3;2;1;2;3;1;12
22;Coehorn Mortar;3;3;1;1;4;2;14
25;Royal Mortar;4;3;1;1;5;2;16
29;Flying Battery;5;4;2;2;4;3;20
